newtork -> مجموعه ای از کامپیوتر ها که در کنار هم به هم متصل میشوند و از منابع را به اشتراک میگذارند میکنند 
Resource -> منابعی مانند فایل ها و ویدیو ها و غیره که به اشتراک گذاشته میشوند را میگویند
Certificate -> به معنای گواهینامه است
Exam -> آزمون
Operation ->  فرایند ها و عملیات هایی که در شبکه در حال انجام است
Security -> امنیت
Troubleshoot -> رفع اشکال
Domain -> دامنه و به معنای حوزه ایی که یک موضوع پوشش میدهد
Router -> مسیریاب 
Switch -> یک دستگاهی که کامپیوتر ها را به هم وصل میکند
Firewall -> نرم افزار یا سخت افزاری است که ما را از دسترسی غیر مجاز به شبکه جلو گیری میکند
IDS -> در صورتی که به شبکه نفوذی اتفاق بیافتد به ما اطلاع میدهد
IPS -> در صورتی که به شبکه نفوذی اتفاق بیافتد به ما اطلاع میدهد و علاوه برا آن تا حدید میتواند از نفوذ جلوگیری کند
Wireless -> بیسیم
Access Point -> به امثال دکل یا مودم که از طریق ارتباط وایرلس میتوان به آن دوصل شد
Packet -> وقتی در شبکه کامپیوتری بخواهد به کامپیوتر دیگری اطلاعتی را بفرستد آن اطلاعات را به بسته  های کوچک تبدیل میکند و ارسال میکند که به آن پکت میگویند
Protocol -> یک زبان مشترک برای برقراری ارتباط 
Node -> گره -> [
    :: Node Active -> به نود هایی گفته میشود که در شبکه فعال هستند 
    ::‌ Node Paasive -> به نود های غیر فعال در شبکه گفته میشود
]
Service -> خدمات
Static -> ثابت 
Dynamic -> در حال تغییر
Lease -> اجاره کردن 

---------------------------------------------------

Server -> سرور
Client -> مشتری 
Option -> امکانات
Optional -> اختیاری
Port -> درگاه
// وسیله ای است که با آن ارتباط برقرار میکنیم
Hub -> منسوخ شده است به معنای سوييچ در شبکه است اما برخلاف سوییچ اهمه اطلاعات را منتشر میکند
Copper ->  مسی
Field -> زمینه رشته
Connection -> ارتباط 
Connector -> متصل کننده
Shield -> عایق
Cable -> کابل
Full -> کامل
Partial ->  کمی تا قسمتی
Hybrid ->  ترکیبی
Peer To Peer ->  نظیر به نظیر
// اگر یک کامپیوتر در شبکه همزمان هم کلاینت و هم سرور باشد به آن شبکه نظیر به نظیر میگویند
Media ->  رسانه
Medium ->  
Remote ->  از راه دور
Logical ->  منطقی اما قابل لمس نیست
Physical ->   به صورت فیزیکی قابل لمس هستند

------------------------------------------------------------------------------------

Configure -> پیکربندی
Implement -> پیاده سازی
Maintain -> نگهداری
Manage -> مدیریت
Compression -> فشرده سازی
Encryption -> رمز نگاری
Address -> آدرس
Layer -> لایه
Private -> خصوصی
Public -> عمومی
Valid -> مورد تایید
Invalid -> غیر معتبر
Unicast -> ارتباط یک به یک
Multicast -> ارتباط یک به چند
Broadcast -> ارتباط یک به همه
Collision -> تداخل
Loop -> دور خود چرخیدین
Route -> آدرس 
Default -> پیش فرض
Availablitity -> دسترسی پذیری

----------------------------------------------------------------------

Virtual -> ماهیت فیزیکی ندارد
Interior -> داخلی
Exterior ->  خارجی
BandWidth -> پهنای باند
Speed -> سرعت
Limit -> محدودیت
Latency -> تاخیر
Administrator -> مدیر سیستم 
Hop -> به کدام از پرش هایی که اطلاعات ما در شبکه انجام میدهد میگویند 
Count -> تعداد
Distance -> مسافت
Distribution -> توضیع کردن
VoIp -> ارتباطاط صوتی که بر اساس آیپی انجام میشوند
Qos -> سرویسی است که باعث میشود اطلاعات پس و پیش نشوند و دقیق منتقل شوند
Realtime -> در لحضه
Gateway -> دروازه
NIC -> کارت رابط شبکه 
Channel -> کانال
Attach -> متصل کردن 
Detach -> جدا کردن 
Storage -> فضای ذخیره سازی

--------------------------------------------------------

Requirement -> نیازمندی ها 
Type -> انواع 
Environment ->محیط 
Equipment -> تجهیزات
Compatibility -> هماهنگ بودن
Consideration -> توجه
Recommendation -> توصیه کردن . پیشنهاد دادن 
Analyze -> آنالیز
Monitoring -> پایش کردن
Alert -> اخطار
Warning -> هشدار
Tool -> ابزار
Utility -> ابزار
Report -> گزارش
Link -> ارتباط
BaseLine -> الگو
Best practice -> یک کار در گذشته انجام شده است و نتیجه مثبت داده است
Bottleneck -> قیف
Log -> هر اتفاق را ذخیره میکند
Utilization -> بهره وری
Status -> وضعیت

------------------------------------------------------

Discard -> بیخیال شدن
Drop -> زمین زدن
Duplex -> همزمانی انتقال داده 
Support -> پشتیبانی
Error -> خطا
Archive -> ذخیره سازی اطلاعات بر روی یک دستگاه خارج از هارد دیسک
Backup -> نسخه پشتیبان
Mobile -> همراه
Asset -> دارایی
Vendor ->  وابستگی
Policy ->  خط مشی / سیاست
Procedure ->  دستور العمل
Legacy ->  قدیمی / سنتی
Separate ->  جدا / تفکیک
Laboratory ->  آزمایشگاه
Load Balancing -> تقسیم فشار سرور  
Documentation ->  مستند سازی
Compliance ->  عدم انتباق
Performance -> کارایی
Optimize ->  بهینه سازی
Apply -> اعمال کردن

----------------------------------------------

Update -> بروزرسانی
Upgrade -> بروز رسانی به درجات بالاتر
Driver -> یک رابط بین نرم افزار و سخت افزار
Firmware -> میان افزار
Feature -> قابلیت
Change -> عوض کردن / تغییرات
Major -> اساسی
Minor ->  جزیی
Downgrade -> برگشتن به حالت قبل 
Forward -> هدایت کردن
Flood -> طوفان / سر ریز گردن
Filter -> جدا کردن 
Assign -> تخصیص دادن / نسبت دادن 
Console -> ارتباط با سیستمی که از راه دور نیست
Terminal -> محلی برای وارد کردن دستورات
Roaming -> جابجایی
Pool -> از هر سرویس چند تا داشته باشیم
Toplogy -> نحوه به هم وصل کردن کامپیوتر
Infrastructure -> زیر ساحتار
Disaster -> فاجعه
Recovery -> بازگردانی

------------------------------------------------------------------------

Single Point Of Failer -> در صورتی اتفاق می افتد که یک قسمتی از شبکه از کار بی افتد و کل شبکه را از کار بی اندازد
Awareness -> اطلاع رسانی 
Training -> آموزش
Critical -> حساس / حیاطی
Redundancy -> افزونگی
Vulnerability -> آسیب پذیری
Penetration -> نفوذ 
Attack -> حمله 
Threat -> تهدید 
Amplifier -> تقویت کننده
Permanet -> دایمی
Persistent -> دایمی
Abuse -> سو استفاده
Spoof -> جعل هویت / جعل آدرس 
Session -> جلسه
Compromised -> سو استفاد شده  / غیر قابل اعتماد
Effect -> تاثیر گذاری
Mailcious -> مخرب
Hardening -> به زمانی گفته میشود که پورت های غیر صروری را در یک سیستم غیر فعال میکنیم
Inspection -> پیدا کردن

---------------------------------------------------------------

Segmentation -> تفکیک کردن
Access List -> لیست دسترسی
EnterPrise -> شرکت
Personal -> شخصی 
Authentication -> احراز هویت
Authorization -> مجوز دسترسی
Content -> محتوا
Allow -> پذیرش
Deny -> اجاز ندادن
Application -> برنامه
Software -> نرم افزار 
Hardeware -> سخت افزار 
Block -> مسدود کردن
Inbound -> ترافیک ورودی 
Outbound -> ترافیک خروجی
Assessment -> ارزیابی
Quarantine -> قرنطینه
Edge -> لبه
Escalate -> بالا بردن سطح دسترسی
Transport -> انتقال
Legal -> قانونی

-----------------------------------------------------------------------------

Illegal -> غیر قانونی 
Discovery -> شناسایی
Evidence -> مدرک جرم باقیمانده
Gather -> اطلاعات به دست آوردن
Resolve -> حل کردن 
Solution -> راه حل
Functionality -> عملیاتی بودن
loss -> از بین رفتن
Noise -> اختلال
Simultaneous -> همزمان 
Concurrent -> همزمان 
Trusted -> مورد اعتماد
Encapsulation -> فرایند تبدیل اطلاعات به کپسول هایی برای ارسال
De-Encapsulation ->  فرایند هایی برای باز کردن کپسول های ارسال شده 
Binary -> باینری / مبنای دو 
Octal -> مبنای هشت
Decimal -> مبنای ۱۰
Hexadecimal -> مبنای ۱۶ 
Basebande -> شبکه ای که فقط یک سیگنال از آن قابل عبور است 
Broadband -> شبکه ای که به صورت همزمان چند سیگنال میتواند از آن عبور کند
SLA -> قرار داد با سازمانی که به ما خدمات میدهد 
Safety -> ایمینی
Rollback -> بازگردانی به حالت قبل
Simplex -> ارتباط یک طرفه 
Half Duplex -> دو طرفه اما در حین صحبت یک نفر نفر دیگر نمیتواند صحبت کند مثل بیسیم 
Full Duplex ->  ارتباط دو طرفه و هر کس میتواند صحبت کند

--------------------------------------------------------------------------
